12 12 2 0
S#..........
.#.#.#######
...#........
####.#######
............
.###########
............
............
............
............
............
............